***********
*         *
* ***** * *
S   *   * *
*** * *** *
*     *   *
* * *** ***
* *   *   E
* *** * * *
*     *   *
***********